de foto=la photo
het bericht=le message
de reactie=la réaction
het commentaar=le commentaire
de site=le site
de app=l'appli
de social media=les réseaux sociaux
de mobiele telefoon=le portable
de rekening=l'addition
zeggen=dire
denken=penser
wachten=attendre
gebruiken=utiliser
werken=travailler
betalen=payer
ik ga weg=j'y vais
hij ziet=il voit
geef mij=donne-moi
ik heb gezien=j'ai vu
veel plezier=amuse-toi bien
wij waren=on était
gaat het goed met je?=tu vas bien?
welkom=bienvenue
tot later=à plus
dankzij=grâce à
voor (plaats)=devant
achter=derrière
dichtbij=près de
gelukkig=heureux
grappig=drôle