ik volg=je suis
ik stuur=j'envoie
(aan)maken=créer
het account=le compte
gebruiken=utiliser
toevoegen=ajouter
achterlaten=laisser
het bericht=le commentaire
downloaden=télécharger
de applicatie=l'application
de app=l'appli
het bericht=le message
de mensen=les gens
de maten=les potes
beroemd=célèbre
digitaal=numérique
hip, in de mode=branché
ouderwets=démodé
dat wil zeggen=c'est-à-dire
heb je daar zin in?=ça te dit?
er bestaat/bestaan=il existe
ik word=je deviens
ik heb zojuist=je viens de
laat zien=fais voir
vroeger=avant
bijna=presque
de hele tijd=tout le temps
vaak=souvent
jammer genoeg=malheureusement
dat is jammer=c'est dommage
het is niet erg=ce n'est pas grave